1111111111111
1000010C00001
1000000000001
1000300000111
11111000000C1
101P000100001
13C0301E01001
1111111111111