1111111111111111111111111111111111
130000E000030000000003000000000001
10100110001000000000010000C0010101
1010010000101000000111000000010101
100000000000C300000000003000P003C1
1111111111111111111111111111111111