1111111111111
10C00100000P1
1000000000001
1000000000111
11111000000C1
1000000000001
10C0000E00001
1111111111111