1111111111111111111111111111111111
100000E10000000000000C000000000001
101000010000000C100001000000010101
1010000010101011100001000000010101
100000000C00C0000000000000000P01C1
1111111111111111111111111111111111